2 2 2 2 2 2 2 2 2 2 2 2 2 2 2 2 2 2 2 2 2 2 2 2 2 2 2 2 2 2 2 2 2 2 2 2 2 2 2 2 2 2 2 2 2 2 2 2 2 2 2 2 2 2 2 2 2 2 2 2 2 2 2 2 2 2 2 2 2 2 2 2 2 2 2 2 2 2 2 2 2 2 2 2 2 2 2
2 2 2 2 2 2 2 2 2 2 2 2 2 2 2 2 2 2 2 2 2 2 2 2 2 2 2 2 2 2 2 2 2 2 2 2 2 2 2 2 2 2 2 2 2 2 2 2 2 2 2 2 2 2 2 2 2 2 2 2 2 2 2 2 2 2 2 2 2 2 2 2 2 2 2 2 2 2 2 2 2 2 2 2 2 2 2
2 2 2 2 2 2 2 2 2 2 2 2 2 2 2 2 2 2 2 2 2 2 2 2 2 2 2 2 2 2 2 2 2 2 2 2 2 2 2 2 2 2 2 2 2 2 2 2 2 2 2 2 2 2 2 2 2 2 2 2 2 2 2 2 2 2 2 2 2 2 2 2 2 2 2 2 2 2 2 2 2 2 2 2 2 2 2
2 2 2 2 2 2 2 2 2 2 2 2 2 2 2 2 2 2 2 2 2 2 2 2 2 2 2 2 2 2 2 2 2 2 2 2 2 2 2 2 2 2 2 2 2 2 2 2 2 2 2 2 2 2 2 2 2 2 2 2 2 2 2 2 2 2 2 2 2 2 2 2 2 2 2 2 2 2 2 2 2 2 2 2 2 2 2
2 2 2 2 2 2 2 2 2 2 2 2 2 2 2 2 2 2 2 2 2 2 2 2 2 2 2 2 2 2 2 2 2 2 2 2 2 2 2 2 2 2 2 2 2 2 2 2 2 2 2 2 2 2 2 2 2 2 2 2 2 2 2 2 2 2 2 2 2 2 2 2 2 2 2 2 2 2 2 2 2 2 2 2 2 2 2
2 2 2 2 2 2 2 2 2 2 2 2 2 2 2 2 2 2 2 2 2 2 2 2 2 2 2 2 2 2 2 2 2 2 2 2 2 2 2 2 2 2 2 2 2 2 2 2 2 2 2 2 2 2 2 2 2 2 2 2 2 2 2 2 2 2 2 2 2 2 2 2 2 2 2 2 2 2 2 2 2 2 2 2 2 2 2
2 2 2 2 2 2 2 3 3 3 3 46 47 3 3 3 3 3 3 3 3 3 3 3 3 3 3 3 3 3 3 3 3 3 3 3 3 3 78 0 0 0 4 4 0 0 4 0 0 0 4 0 0 0 0 0 4 4 0 0 0 4 0 0 0 0 0 0 0 4 4 0 6 0 0 0 4 4 0 0 5 2 2 2 2 2 2 
2 2 2 2 2 2 2 3 3 3 3 48 49 3 3 3 3 3 3 3 53 54 55 56 57 3 3 3 3 3 3 3 3 3 46 47 3 3 76 0 0 0 4 0 4 0 0 0 6 0 0 0 5 0 4 7 8 0 0 0 0 0 0 0 0 4 0 0 0 6 11 0 0 5 0 4 11 0 0 0 0 2 2 2 2 2 2
2 2 2 2 2 2 2 3 3 3 3 3 3 3 3 3 46 47 3 3 58 59 60 61 62 3 3 3 3 3 3 3 3 3 48 49 3 3 76 0 0 4 0 5 5 0 0 0 0 0 0 0 0 0 0 9 10 0 6 0 5 0 5 4 0 5 0 4 0 0 12 0 0 4 4 0 12 0 0 4 0 2 2 2 2 2 2
2 2 2 2 2 2 2 3 3 3 3 3 3 3 3 3 48 49 3 3 63 64 65 66 67 3 3 3 3 3 3 3 3 3 3 3 3 3 76 0 0 0 0 4 4 0 6 0 0 0 4 4 0 0 5 0 4 0 0 0 4 0 0 0 0 6 0 0 4 0 4 0 6 0 0 0 0 0 0 0 0 2 2 2 2 2 2
2 2 2 2 2 2 2 3 3 3 3 3 3 3 3 3 3 3 3 3 68 69 70 71 72 3 3 3 3 3 3 3 3 3 3 3 3 3 76 0 4 0 4 0 0 0 0 0 0 0 0 0 0 0 0 0 0 0 0 0 0 0 0 11 0 0 4 0 13 14 15 16 17 18 0 0 11 4 6 0 5 2 2 2 2 2 2
2 2 2 2 2 2 2 3 46 47 3 3 3 3 3 3 3 3 3 3 3 3 3 3 3 3 3 46 47 3 3 3 46 47 3 3 3 3 76 0 0 0 4 4 0 0 4 0 5 0 4 0 0 0 0 0 4 4 0 0 0 0 4 12 0 0 0 0 19 20 21 22 23 24 4 0 12 0 0 4 0 2 2 2 2 2 2
2 2 2 2 2 2 2 3 48 49 3 3 3 3 3 3 3 3 3 46 47 3 3 3 3 3 3 48 49 3 3 3 48 49 3 3 3 3 76 0 4 0 4 0 0 0 0 0 0 0 0 0 0 0 0 5 0 0 0 0 0 0 0 0 0 4 11 0 25 26 27 28 29 30 0 0 0 0 5 0 0 2 2 2 2 2 2
2 2 2 2 2 2 2 3 3 3 3 3 3 3 3 3 3 3 3 48 49 3 3 3 3 3 3 3 3 3 3 3 3 3 3 3 3 3 76 0 0 4 6 6 0 0 0 7 8 4 0 0 6 0 0 0 0 0 0 0 4 6 0 5 0 0 12 0 31 32 33 34 35 36 0 0 0 0 0 5 0 2 2 2 2 2 2
2 2 2 2 2 2 2 3 3 3 3 3 3 3 3 3 3 3 3 3 3 3 3 3 3 3 3 3 3 3 3 3 3 3 3 3 3 3 76 0 0 0 4 4 0 0 4 9 10 0 4 0 0 0 7 8 4 4 0 0 0 0 0 0 0 4 4 0 0 0 0 0 0 0 0 0 0 0 0 0 0 2 2 2 2 2 2
2 2 2 2 2 2 2 3 3 3 3 3 3 3 3 3 3 3 3 3 3 3 3 3 3 3 3 3 3 3 3 3 3 3 3 3 3 3 76 0 0 0 0 0 0 0 0 0 0 0 0 4 0 0 9 10 0 0 0 0 0 0 4 0 0 7 8 6 0 0 0 0 5 0 0 7 8 0 0 0 6 2 2 2 2 2 2
2 2 2 2 2 2 2 3 3 3 3 3 3 3 3 46 47 3 3 3 3 3 3 3 3 3 3 3 3 3 3 3 46 47 3 3 3 3 76 0 0 0 0 0 0 0 0 0 0 5 0 0 4 0 0 0 0 0 0 0 0 0 4 0 0 9 10 0 5 0 4 0 0 0 4 9 10 0 0 6 0 2 2 2 2 2 2
2 2 2 2 2 2 2 3 3 46 47 3 3 3 3 48 49 3 3 3 3 3 46 47 3 3 3 46 47 3 3 3 48 49 3 3 3 3 76 0 4 4 0 0 5 0 0 0 0 0 0 0 0 0 0 4 0 0 0 0 4 0 0 0 0 0 0 50 0 0 0 0 4 0 0 5 0 0 0 0 5 2 2 2 2 2 2
2 2 2 2 2 2 2 3 3 48 49 3 3 3 3 3 3 3 3 3 3 3 48 49 3 3 3 48 49 3 3 3 3 3 3 3 3 3 76 0 0 0 0 4 0 0 4 4 0 0 0 0 0 0 0 0 0 0 0 0 0 0 7 8 0 0 0 4 0 7 8 4 0 0 0 0 0 0 0 0 0 2 2 2 2 2 2
2 2 2 2 2 2 2 3 3 3 3 3 3 3 3 3 3 3 3 3 3 3 3 3 3 3 3 3 3 3 3 3 3 3 3 3 3 3 76 0 0 4 0 5 0 0 4 0 0 6 0 0 5 7 8 0 0 0 0 5 0 0 9 10 4 0 0 0 0 9 10 0 0 0 5 0 7 8 4 4 0 2 2 2 2 2 2
2 2 2 2 2 2 2 3 3 3 3 3 3 3 3 46 47 3 3 3 3 3 3 3 3 3 3 3 3 3 3 3 3 3 3 3 3 3 76 0 4 0 0 0 0 0 0 0 0 0 0 0 0 9 10 0 0 4 0 0 5 0 0 0 0 0 4 0 0 0 4 0 0 0 0 6 9 10 4 0 4 2 2 2 2 2 2
2 2 2 2 2 2 2 3 3 46 47 3 3 3 3 48 49 3 3 3 3 3 3 3 46 47 3 3 3 3 3 3 3 46 47 3 3 3 76 0 4 0 0 4 0 0 0 0 0 6 0 0 0 0 0 4 0 0 0 0 0 4 0 0 0 0 0 0 4 0 0 6 0 0 5 0 0 0 0 0 4 2 2 2 2 2 2
2 2 2 2 2 2 2 3 3 48 49 3 3 3 3 3 3 3 3 3 3 3 3 3 48 49 3 3 3 3 3 3 3 48 49 3 3 3 76 0 0 5 0 0 4 0 0 0 0 0 0 0 6 0 0 0 0 5 0 0 0 0 0 0 0 0 0 0 6 7 8 0 0 0 6 0 0 0 4 0 0 2 2 2 2 2 2
2 2 2 2 2 2 2 3 3 3 3 3 3 3 3 3 3 3 3 3 3 3 3 3 3 3 3 3 3 46 47 3 3 3 3 3 3 3 76 0 0 0 0 0 0 0 4 0 0 0 0 0 0 0 0 0 0 0 0 0 0 5 7 8 0 5 0 5 4 9 10 0 4 0 0 7 8 0 0 0 0 2 2 2 2 2 2
2 2 2 2 2 2 2 3 3 3 3 3 3 46 47 3 3 3 3 3 3 3 3 3 3 3 3 3 3 48 49 3 3 3 3 3 3 3 76 0 0 0 0 0 0 0 0 0 0 0 0 4 0 0 0 4 0 0 0 0 0 0 9 10 0 0 0 4 0 0 0 4 0 0 0 9 10 0 0 0 0 2 2 2 2 2 2
2 2 2 2 2 2 2 3 3 3 3 3 3 48 49 3 3 3 3 3 3 3 3 3 3 3 3 3 3 3 3 3 3 3 3 3 3 3 77 0 4 4 0 6 0 0 4 0 4 0 6 0 0 0 0 0 0 0 0 0 0 0 0 0 0 0 6 0 0 5 0 0 0 0 0 0 5 0 0 4 0 2 2 2 2 2 2
2 2 2 2 2 2 2 6 0 0 0 0 0 0 0 0 6 0 0 0 0 0 0 0 5 6 0 0 0 0 5 0 0 0 0 6 0 5 4 0 0 0 0 0 0 0 0 0 0 0 0 0 0 0 0 0 0 0 0 4 0 0 0 0 0 4 0 0 0 0 6 0 0 0 0 5 0 0 0 4 4 2 2 2 2 2 2
2 2 2 2 2 2 2 0 0 0 0 0 4 4 0 0 0 0 0 6 5 0 0 0 0 0 0 0 4 4 0 0 0 5 5 0 0 0 0 0 0 4 4 0 0 0 5 0 0 0 0 5 0 4 0 0 4 0 0 0 4 0 0 4 0 0 0 0 0 0 0 0 0 0 0 0 0 0 4 0 6 2 2 2 2 2 2
2 2 2 2 2 2 2 0 0 0 4 0 0 0 4 4 0 0 0 0 0 0 0 0 4 0 0 0 0 0 0 0 0 0 0 0 0 0 0 0 4 0 0 0 0 0 0 0 0 0 0 0 0 0 0 0 0 0 0 0 0 0 0 0 0 0 6 0 5 0 5 4 0 5 0 4 0 0 0 0 0 2 2 2 2 2 2
2 2 2 2 2 2 2 0 0 0 0 0 0 0 0 0 0 5 0 0 0 0 4 0 0 0 0 0 0 0 0 0 0 4 4 4 4 4 4 0 4 0 0 0 0 0 0 0 6 0 0 0 6 0 0 0 0 0 6 0 0 0 4 0 0 0 0 0 0 5 0 0 4 0 0 0 0 0 0 0 0 2 2 2 2 2 2
2 2 2 2 2 2 2 4 4 0 0 0 0 4 0 0 0 0 4 0 0 0 4 0 0 0 0 0 0 4 4 4 5 0 0 0 0 0 0 0 0 0 4 4 0 0 4 0 0 0 4 0 0 0 0 0 4 4 0 5 0 0 0 0 0 0 0 0 4 0 0 5 0 0 0 0 0 4 0 0 0 2 2 2 2 2 2
2 2 2 2 2 2 2 0 0 0 4 0 0 4 0 0 5 0 4 0 0 4 0 0 0 0 0 0 0 0 4 6 0 0 0 0 0 0 0 0 4 0 0 0 0 0 0 0 0 51 0 0 0 0 5 0 0 0 0 0 0 0 0 0 0 6 0 0 4 0 4 0 6 0 0 0 0 0 0 6 4 2 2 2 2 2 2
2 2 2 2 2 2 2 0 0 0 4 0 0 4 0 0 5 0 4 0 0 4 0 0 0 0 0 0 0 0 4 6 0 0 0 0 0 0 0 0 4 0 0 0 0 0 0 0 0 52 0 0 0 37 38 39 0 0 0 0 0 0 0 0 0 6 0 0 4 0 4 0 6 0 0 0 0 0 0 6 4 2 2 2 2 2 2
2 2 2 2 2 2 2 4 0 5 6 0 0 0 0 0 0 4 4 0 0 0 6 4 4 4 0 0 0 0 0 0 5 0 4 4 4 0 0 0 0 0 0 6 5 5 0 0 0 0 0 0 0 40 41 42 0 0 4 4 4 0 0 0 5 0 0 0 6 0 0 0 0 0 4 0 0 0 0 0 0 2 2 2 2 2 2
2 2 2 2 2 2 2 0 0 0 0 0 0 0 0 0 0 0 0 5 0 0 0 0 0 0 0 0 0 0 0 0 0 0 4 0 0 0 6 6 0 0 0 0 0 0 0 0 0 4 4 4 0 43 44 45 0 0 0 0 0 51 0 0 0 4 4 0 0 0 0 0 0 0 5 0 0 0 0 0 0 2 2 2 2 2 2
2 2 2 2 2 2 2 0 0 0 0 4 4 0 0 0 0 0 0 0 6 0 0 0 0 0 0 0 0 0 6 6 0 0 0 0 0 0 0 0 0 0 0 0 0 0 0 0 0 0 4 0 0 0 0 0 0 0 0 0 0 52 0 5 0 0 0 4 5 0 0 0 0 0 0 0 0 4 0 4 0 2 2 2 2 2 2
2 2 2 2 2 2 2 0 0 0 0 4 0 0 0 0 0 0 0 0 5 0 0 0 0 0 5 0 0 0 0 0 0 4 0 0 0 0 0 0 0 0 0 0 0 0 0 0 0 50 4 0 0 0 0 0 0 0 0 0 0 0 0 0 0 0 0 0 6 0 0 0 0 0 0 0 0 0 0 6 0 2 2 2 2 2 2
2 2 2 2 2 2 2 4 4 5 0 0 0 0 0 0 0 0 0 0 0 0 0 0 0 0 0 0 0 0 0 4 4 4 0 0 0 0 0 5 6 0 0 0 0 0 0 0 0 4 4 0 0 0 0 0 0 0 6 0 0 5 0 0 0 0 0 0 0 0 0 0 0 0 0 0 0 0 6 4 4 2 2 2 2 2 2
2 2 2 2 2 2 2 0 0 0 0 0 0 0 6 0 0 0 0 0 0 0 0 0 0 0 0 0 0 0 0 0 0 0 0 0 0 0 0 0 0 0 0 0 0 0 5 5 0 0 0 0 0 0 0 0 0 0 0 0 0 6 0 0 0 0 0 5 0 0 0 0 5 0 0 0 0 0 0 4 4 2 2 2 2 2 2
2 2 2 2 2 2 2 0 0 0 0 0 5 5 0 0 0 0 0 0 0 0 0 6 0 0 0 0 0 6 0 0 0 0 0 4 4 0 0 0 0 0 4 0 0 0 0 0 4 0 0 0 0 0 0 0 0 5 5 0 0 0 0 0 0 0 0 0 6 6 0 0 0 0 0 0 0 0 5 0 4 2 2 2 2 2 2
2 2 2 2 2 2 2 0 0 0 0 4 4 4 0 0 0 0 5 0 0 0 0 4 4 0 4 0 0 4 0 0 0 0 0 0 0 0 0 0 0 0 0 4 0 0 0 4 4 0 0 0 0 0 0 0 0 0 4 4 4 0 0 0 0 0 0 0 0 0 0 0 6 0 0 0 0 0 0 5 0 2 2 2 2 2 2
2 2 2 2 2 2 2 0 0 0 0 0 0 0 0 0 0 0 0 0 0 0 5 0 0 6 0 0 0 0 0 4 0 0 0 0 5 0 0 0 0 0 4 0 0 0 0 0 0 0 0 0 0 0 0 0 0 0 0 0 0 0 0 0 0 0 0 0 0 0 0 0 0 0 5 0 0 0 0 0 0 2 2 2 2 2 2
2 2 2 2 2 2 2 0 0 0 0 0 0 4 4 4 0 0 0 0 4 4 0 0 0 0 0 0 0 0 0 0 0 0 4 4 0 0 0 0 0 0 0 0 0 4 0 0 0 0 0 0 0 0 5 5 0 0 0 5 0 0 0 0 0 0 0 6 0 0 0 0 0 4 0 0 0 4 4 0 0 2 2 2 2 2 2
2 2 2 2 2 2 2 4 0 0 5 0 0 5 0 0 0 0 0 0 0 0 0 0 0 0 4 4 0 0 0 0 0 0 0 0 0 0 0 0 0 0 0 0 0 0 6 0 0 0 0 0 0 0 0 0 0 0 0 0 0 0 0 0 0 0 0 0 0 0 0 0 4 4 6 0 0 0 0 0 0 2 2 2 2 2 2
2 2 2 2 2 2 2 0 0 0 0 0 4 4 0 0 0 0 0 0 0 0 0 0 0 0 0 0 0 4 4 0 0 5 5 0 0 0 0 6 0 0 0 0 5 5 0 0 0 0 0 0 0 4 4 0 0 0 0 0 4 0 0 0 0 0 0 0 0 4 4 0 0 0 0 0 0 0 0 0 6 2 2 2 2 2 2
2 2 2 2 2 2 2 0 0 0 0 0 4 0 0 0 0 0 0 0 0 0 0 0 6 6 0 0 0 0 4 4 0 0 0 0 0 0 0 0 0 0 0 0 0 0 0 0 0 0 0 4 5 0 0 0 0 0 0 0 0 0 0 0 0 0 0 4 4 0 0 0 0 0 0 0 0 0 0 5 0 2 2 2 2 2 2
2 2 2 2 2 2 2 4 4 0 0 0 6 4 0 0 0 0 0 0 0 4 4 0 0 0 0 0 0 0 0 0 0 0 0 0 0 0 0 0 0 0 4 4 0 0 0 0 0 4 4 4 0 0 0 0 0 0 0 0 0 0 0 0 0 0 4 0 0 0 0 5 5 0 0 0 0 0 0 0 0 2 2 2 2 2 2
2 2 2 2 2 2 2 0 0 0 0 0 0 0 0 0 0 0 0 0 0 0 0 0 0 5 5 0 0 0 0 0 0 0 4 4 4 4 0 0 0 0 0 0 0 0 0 0 6 6 0 0 0 0 0 0 0 0 5 4 4 0 0 0 0 0 0 0 4 4 0 0 0 0 6 0 0 0 0 0 0 2 2 2 2 2 2
2 2 2 2 2 2 2 0 0 0 4 4 0 0 0 0 5 5 4 0 0 0 0 0 0 0 0 0 0 0 0 4 4 0 0 0 0 0 0 0 0 0 0 0 0 0 5 0 0 0 0 0 0 0 0 0 0 0 0 0 0 0 0 0 0 0 0 0 4 4 4 6 0 0 0 0 0 4 0 0 0 2 2 2 2 2 2
2 2 2 2 2 2 2 0 0 0 0 0 0 5 5 6 0 0 0 0 0 0 0 0 0 0 0 4 4 0 0 0 0 0 0 0 0 0 0 0 0 0 0 0 5 5 0 0 0 0 0 6 0 0 0 0 0 0 0 0 0 0 0 6 0 0 0 6 0 0 5 0 0 0 0 0 0 0 0 0 0 2 2 2 2 2 2
2 2 2 2 2 2 2 0 0 0 0 0 4 4 0 0 0 0 0 0 4 0 0 0 0 0 0 0 4 0 0 0 0 0 0 0 0 0 0 0 5 0 0 0 0 0 0 0 0 0 0 0 0 0 0 0 6 0 0 0 0 0 0 0 0 0 0 0 0 0 0 6 0 0 0 0 0 5 5 5 0 2 2 2 2 2 2
2 2 2 2 2 2 2 0 0 0 0 0 0 4 4 0 0 0 0 0 0 0 0 0 6 6 0 0 0 0 0 0 0 0 0 0 0 0 0 0 0 0 0 0 0 0 0 0 0 0 0 0 0 0 5 5 0 0 4 4 0 0 0 0 0 0 0 0 0 0 0 0 0 5 0 0 0 0 0 0 0 2 2 2 2 2 2
2 2 2 2 2 2 2 5 5 0 0 0 0 0 0 0 0 6 6 0 0 0 0 0 0 0 0 0 0 0 0 0 0 0 0 0 0 0 0 0 4 4 4 4 4 0 0 0 0 0 0 0 0 0 0 0 0 0 5 0 0 0 0 0 0 0 0 0 5 5 0 0 0 0 0 0 0 6 0 0 0 2 2 2 2 2 2
2 2 2 2 2 2 2 0 0 0 0 0 0 0 0 4 4 4 0 0 0 0 0 0 0 0 0 0 5 6 0 0 0 0 0 0 0 0 0 0 0 5 5 0 0 0 0 0 0 4 0 0 0 0 0 0 6 6 0 0 0 0 0 0 0 0 0 0 0 0 0 6 0 0 4 4 0 0 4 0 0 2 2 2 2 2 2
2 2 2 2 2 2 2 0 0 0 5 5 0 0 0 0 0 0 4 4 0 0 0 0 0 0 6 6 0 0 0 0 0 0 0 0 0 0 0 0 0 0 0 0 0 0 4 4 4 5 0 0 0 0 0 0 0 0 0 6 0 0 0 0 0 5 0 0 0 0 5 0 0 0 0 6 0 0 0 0 0 2 2 2 2 2 2
2 2 2 2 2 2 2 5 5 4 4 0 0 0 0 0 0 0 0 6 6 0 0 0 0 0 0 0 0 0 0 4 4 0 0 0 0 0 0 4 0 0 0 0 5 5 0 0 0 0 0 0 0 6 0 0 0 0 0 5 0 0 0 0 0 0 0 0 0 0 0 0 0 0 4 4 4 4 0 0 0 2 2 2 2 2 2
2 2 2 2 2 2 2 0 0 0 0 0 6 6 6 0 0 0 0 0 0 0 4 4 4 0 0 0 0 0 0 0 0 0 0 0 0 5 5 0 0 0 0 0 6 0 0 0 0 0 0 0 5 5 5 0 0 0 4 4 4 0 0 4 0 0 4 0 0 0 0 4 0 0 0 0 0 0 4 0 0 2 2 2 2 2 2
2 2 2 2 2 2 2 4 0 0 0 0 0 0 0 0 0 0 5 5 5 0 0 0 0 0 6 0 0 0 0 0 0 6 6 0 0 4 4 0 0 4 5 4 0 0 0 0 0 0 0 0 4 0 0 0 0 0 0 5 0 0 0 6 6 0 0 0 0 0 0 0 0 0 0 0 0 0 5 5 0 2 2 2 2 2 2
2 2 2 2 2 2 2 0 0 0 0 0 5 5 5 0 0 0 0 0 0 0 4 4 0 0 5 5 0 0 0 0 5 5 0 0 0 0 4 4 0 0 0 0 0 0 0 0 4 4 5 0 0 0 0 0 0 0 0 0 6 0 0 0 5 0 0 0 0 0 0 0 0 0 0 4 4 4 0 0 0 2 2 2 2 2 2
2 2 2 2 2 2 2 0 0 0 0 4 4 4 0 0 0 0 0 0 0 4 4 0 0 0 0 5 5 0 0 0 6 6 6 0 0 0 0 0 0 0 0 0 0 0 0 0 0 0 0 4 4 4 0 0 0 0 0 0 0 0 0 0 0 4 4 0 0 0 0 0 0 0 0 0 0 0 4 4 4 2 2 2 2 2 2
2 2 2 2 2 2 2 0 0 0 0 0 0 0 0 0 0 4 4 4 4 0 0 0 0 0 0 0 0 0 0 0 5 0 0 0 0 4 4 0 0 0 0 0 0 0 0 5 5 0 0 0 0 6 0 0 0 4 4 0 0 0 0 0 0 5 0 0 0 0 0 0 0 0 0 0 0 0 0 0 0 2 2 2 2 2 2
2 2 2 2 2 2 2 5 4 4 4 0 0 0 0 0 0 0 0 0 0 0 0 0 0 6 6 0 0 0 0 0 0 5 5 5 0 0 0 0 0 0 0 0 0 0 5 5 0 0 0 0 0 0 0 0 0 0 0 0 0 0 0 0 0 4 4 4 0 0 0 0 0 0 5 0 0 0 0 0 0 2 2 2 2 2 2
2 2 2 2 2 2 2 0 0 0 0 0 6 0 0 0 4 4 4 0 0 0 0 0 0 0 0 0 4 4 4 0 0 0 0 0 0 4 6 6 0 0 0 0 0 0 0 0 0 0 0 0 0 0 0 4 4 4 4 4 0 0 0 5 6 0 0 0 6 0 0 0 0 0 0 0 0 0 0 0 0 2 2 2 2 2 2
2 2 2 2 2 2 2 6 0 0 0 0 0 0 0 0 0 0 0 0 0 0 0 0 0 0 4 4 4 4 0 0 0 0 0 0 0 0 0 0 5 5 5 0 0 0 0 4 4 0 0 0 0 0 0 0 0 0 0 0 0 0 0 4 4 4 0 0 0 0 0 0 0 0 0 0 0 0 0 4 0 2 2 2 2 2 2
2 2 2 2 2 2 2 0 0 0 0 0 0 4 4 4 0 0 0 0 5 5 6 0 0 0 0 0 0 0 0 0 0 0 5 5 0 0 0 0 0 4 4 0 0 0 0 0 0 0 0 0 0 0 0 0 0 4 4 4 4 0 0 0 0 0 4 4 0 0 0 0 6 6 0 0 0 0 4 4 5 2 2 2 2 2 2
2 2 2 2 2 2 2 0 0 0 0 0 0 0 0 0 4 4 0 0 0 0 0 0 0 0 0 0 6 6 0 0 0 0 0 5 5 5 0 0 0 6 4 4 4 4 4 0 0 0 0 0 0 0 0 0 0 0 0 0 0 0 4 5 6 4 4 0 0 0 0 0 0 0 0 0 0 0 6 0 0 2 2 2 2 2 2
2 2 2 2 2 2 2 5 5 0 0 0 0 0 0 0 0 0 0 0 0 0 0 0 0 4 4 4 0 0 0 0 0 0 0 0 0 0 0 0 5 5 0 0 0 0 0 0 0 0 0 0 5 5 5 0 0 0 0 0 0 0 0 0 0 0 0 0 0 0 0 0 5 5 0 0 0 0 0 0 0 2 2 2 2 2 2
2 2 2 2 2 2 2 5 0 0 0 0 0 0 0 0 0 0 0 0 0 0 0 5 5 0 0 0 0 0 0 0 0 0 0 0 0 0 0 0 0 6 6 0 0 0 0 0 0 0 0 0 0 4 4 4 4 4 0 0 0 0 0 4 5 0 0 0 0 0 0 0 0 0 0 0 4 0 0 0 4 2 2 2 2 2 2
2 2 2 2 2 2 2 0 0 0 0 0 0 0 0 0 0 0 0 0 0 4 4 4 0 0 0 0 0 0 5 5 0 0 0 0 0 0 0 0 0 0 0 0 0 0 0 0 0 4 0 0 0 0 0 0 0 0 0 0 0 0 0 0 0 0 0 0 0 0 6 6 0 0 0 0 0 0 0 0 0 2 2 2 2 2 2
2 2 2 2 2 2 2 4 4 6 0 0 0 0 0 0 0 0 0 0 0 0 0 0 0 0 0 0 0 0 0 0 4 4 0 0 0 0 0 0 0 0 0 0 0 0 0 0 0 0 0 0 0 0 0 4 4 4 0 0 0 0 0 0 0 0 0 0 4 4 0 0 0 0 0 0 0 0 0 0 0 2 2 2 2 2 2
2 2 2 2 2 2 2 0 0 0 0 0 0 0 4 4 4 4 0 0 0 0 0 5 5 0 0 0 0 0 0 0 0 0 0 0 0 0 0 6 6 0 0 0 0 0 0 0 5 5 0 0 0 0 0 5 5 6 0 0 0 0 0 0 0 0 0 0 0 0 0 0 4 4 5 0 0 0 0 0 0 2 2 2 2 2 2
2 2 2 2 2 2 2 6 0 0 0 0 0 0 0 0 0 0 0 0 0 0 0 6 0 0 0 0 0 0 0 0 0 0 0 5 5 0 0 0 0 0 0 0 6 6 0 0 0 0 0 0 0 0 0 0 0 0 0 0 6 6 4 0 0 0 0 0 0 0 0 0 0 4 4 0 0 0 0 0 0 2 2 2 2 2 2
2 2 2 2 2 2 2 0 0 0 0 0 0 4 4 4 6 6 0 0 0 0 0 0 0 0 0 0 0 0 0 0 0 0 0 0 0 0 0 0 4 5 5 0 0 0 0 0 0 0 6 6 6 0 0 0 0 0 0 0 0 6 6 0 0 0 0 0 0 0 4 4 5 0 0 0 0 0 0 0 0 2 2 2 2 2 2 
2 2 2 2 2 2 2 73 73 74 73 73 73 73 74 73 73 74 74 74 74 73 73 73 73 73 73 73 73 73 73 73 74 74 73 73 73 73 73 73 73 73 73 73 74 74 73 73 73 73 73 73 73 73 73 73 73 73 74 74 74 73 73 73 73 74 74 73 73 73 73 73 73 73 73 73 73 73 73 73 73 2 2 2 2 2 2
2 2 2 2 2 2 2 2 2 2 2 2 2 2 2 2 2 2 2 2 2 2 2 2 2 2 2 2 2 2 2 2 2 2 2 2 2 2 2 2 2 2 2 2 2 2 2 2 2 2 2 2 2 2 2 2 2 2 2 2 2 2 2 2 2 2 2 2 2 2 2 2 2 2 2 2 2 2 2 2 2 2 2 2 2 2 2
2 2 2 2 2 2 2 2 2 2 2 2 2 2 2 2 2 2 2 2 2 2 2 2 2 2 2 2 2 2 2 2 2 2 2 2 2 2 2 2 2 2 2 2 2 2 2 2 2 2 2 2 2 2 2 2 2 2 2 2 2 2 2 2 2 2 2 2 2 2 2 2 2 2 2 2 2 2 2 2 2 2 2 2 2 2 2
2 2 2 2 2 2 2 2 2 2 2 2 2 2 2 2 2 2 2 2 2 2 2 2 2 2 2 2 2 2 2 2 2 2 2 2 2 2 2 2 2 2 2 2 2 2 2 2 2 2 2 2 2 2 2 2 2 2 2 2 2 2 2 2 2 2 2 2 2 2 2 2 2 2 2 2 2 2 2 2 2 2 2 2 2 2 2
2 2 2 2 2 2 2 2 2 2 2 2 2 2 2 2 2 2 2 2 2 2 2 2 2 2 2 2 2 2 2 2 2 2 2 2 2 2 2 2 2 2 2 2 2 2 2 2 2 2 2 2 2 2 2 2 2 2 2 2 2 2 2 2 2 2 2 2 2 2 2 2 2 2 2 2 2 2 2 2 2 2 2 2 2 2 2
2 2 2 2 2 2 2 2 2 2 2 2 2 2 2 2 2 2 2 2 2 2 2 2 2 2 2 2 2 2 2 2 2 2 2 2 2 2 2 2 2 2 2 2 2 2 2 2 2 2 2 2 2 2 2 2 2 2 2 2 2 2 2 2 2 2 2 2 2 2 2 2 2 2 2 2 2 2 2 2 2 2 2 2 2 2 2
2 2 2 2 2 2 2 2 2 2 2 2 2 2 2 2 2 2 2 2 2 2 2 2 2 2 2 2 2 2 2 2 2 2 2 2 2 2 2 2 2 2 2 2 2 2 2 2 2 2 2 2 2 2 2 2 2 2 2 2 2 2 2 2 2 2 2 2 2 2 2 2 2 2 2 2 2 2 2 2 2 2 2 2 2 2 2